8 10
U 1 2 R A
U 6 2 B A
U 1 3 R A
U 6 3 B A
U 1 4 R A
U 6 4 B A
U 1 5 R A
U 6 5 B A
U 1 6 R A
U 6 6 B A
U 1 7 R A
U 6 7 B A