10 10
O 4 4
O 5 5
O 4 5
O 5 4
U 1 2 R A
U 7 7 B A
U 2 1 R A
U 7 8 B A
U 2 2 R A
U 8 7 B A